* * * * * * * * * * * * * * * 
* * - * * * * * * * * * * * * 
* * - - * * * * - * * * * - * 
* * - * * * - * - * * * * - * 
* * - * * - - * - - - - * - * 
* * * * - - * * * * - - * - * 
* * * - - - * * * * * - * - * 
* * - - * * * * * * * * * - * 
* * * * * - * * * * * - - * * 
* * - - - - - * * * * - - * * 
* * * * * - - - - * - * * * * 
* * - - * * * - * * - * * * * 
* * * - - - * - * - - * * * * 
* * * * - * * * * - * * * - * 
* * * * * * * * * * * * * * * 

* * * * * * * * * * * * * * * 
- - - - - * * * * - - - - - - 
- - - * * * * * * * - - - * * 
* * * * * - - - - * * * * * * 
* * * * * - - * * * * * * * * 
* * - - - - - - - - * * * * * 
* * * * * * * * * * * * * * * 
* * * * * * * * * * * * * * * 
* * * * * * * * * * * * * * * 
* * * * * * * * * * * * * * * 
- - - - - * * * * * * * * * * 
* * * * * * * * - - - - - - - 
* * * * - - - - - - - * * * * 
* * * * * * * * * * * * * * * 
* * * * * * * * * * * * * * * 

* * * * * * * * * * * * * * * 
* * * * * * * * * * * * * * * 
* * * * * * * * * * * * * * * 
* * * * * * * * * * * * * * * 
* * * * * * * * * * * * * * * 
* * * * * * * * * * * * * * * 
* * * * * * * * * * * * * * * 
* * * * * * * * * * * * * * * 
* * * * * * * * * * * * * * * 
* * * * * * * * * * * * * * * 
* * * * * * * * * * * * * * * 
* * * * * * * * * * * * * * * 
* * * * * * * * * * * * * * * 
* * * * * * * * * * * * * * * 
* * * * * * * * * * * * * * * 

* * * * * * * * * * * * * * * 
* * - * * * - * * * * * - - * 
* * - * * * * * - * * * - * * 
* * * * * * * * - * * * * * * 
* * * * * * * * * * * * * * * 
* * * * * * * * * * * * * * * 
* - * - * * - * - * * * * * * 
* - * - * * - * * * * * * * * 
* * * - * * * - * * * - - - * 
* * * * * * * * * * * * * * * 
* * * - * * * * * * * * * * * 
* * - * * * * - * * * - * * * 
- * * * * * * * * * * * - * * 
* * - * * * - * - * * * * - * 
* * * - * * * * * * * * * * * 

- - - - - - - - - - - - - - - 
- - - - - - - - - - - - - - - 
- - - - - - - - - - - - - - - 
- - - - - - - - - - - - - - - 
- - - - - - - - - - - - - - - 
- - - - - - - - - - - - - - - 
- - - - - - - - - - - - - - - 
- - - - - - * * - - - - - - - 
- - - - - - * * - - - - - - - 
- - - - - - - - - - - - - - - 
- - - - - - - - - - - - - - - 
- - - - - - - - - - - - - - - 
- - - - - - - - - - - - - - - 
- - - - - - - - - - - - - - - 
- - - - - - - - - - - - - - - 

